Text Commands:

!help	List of commands (DM)
!8ball [question]	8ball game (DM)
!custom list	List of custom commands
!coin flip [head] or [tails]	Flip a coin(DM)
!wotd [language]	Word of the day in a language(DM)
.twt [links]	twitter embed(DM)

Remind Commands:

!remind at [date*]>[message]	remind by date (DM)
!remind in [amount**]>[message]	remind in given time (DM)
!remind list	your reminders (DM)
!remind remove [id]	remove a reminder (DM)
*use timezone in the following format:
*22.01.01 01:01 +12 or 01.01 01:01 +12
**years to minutes (e.g. !remind in 15 days >...)

Voice Commands:

!p [url/keyword]	Play music
!join	Join to your channel
!leave	Leaves your channel
!queue	Current queue
!np	Now playing
!clear	Clears queue
!skip	Skip song
!remove [position]	Remove song from queue
!shuffle	Shuffles current playlist

Last.fm commands:

!lf conn [username]	connect last.fm username to you (DM)
!lf del	disconnect last.fm username from you(DM)
!lf np	song you are currently playing (DM)
!lf rc [length(1-30)]	your most recent song (DM)
!lf tar [length(1-30)] [*period]	your top artists (DM)
!lf tal [length(1-30)] [*period]	your top albums (DM)
!lf tt [length(1-30)] [*period]	your top tracks (DM)
!lf artist [artist]	your stats for an artist (DM)
!lf wk [artist]>[track]	ranking on a song or artist
*overall, 7day, 1month, 3month, 6month, 12month

Bias Commands:

!ping [name],[name],...	ping everyone with this bias
!bias add [name]	add bias to your list (DM)
!bias remove [name]	remove bias from your list (DM)
!bias clear	clear your bias list (DM)
!bias list [group]	list all available biases (DM)
!my biases [group]	list my biases (DM)